S#........
.#.#......
..#.......
..........
...###...#
.....#....
.#......#.
....#....#
.#....#..#
.#..#....G
