S...............##..
..#.....##...#......
.#....#...#.........
...........#........
.#...#..#...#.......
..................#.
.....#....#........#
..........#.........
....##.....#.....#..
.#...##....#...#...#
.......#............
.#..................
..#..##...........#.
#........#.......#.#
....#....#...#.#....
..#.#...#....#.....#
#.....#..#.#.....#.#
.##.#.##...##......#
..#.....#.....##.#..
......#...........#G
