S##..#...#.....
..#........##.#
...#.#.#..#.#.#
.#.....###.....
...####..#..#..
#..##.....#..#.
..#.........#..
.....#.....#..#
.#...#.##....##
.#.......##....
.....#####..##.
...######.#...#
......##....#.#
#...#...#......
....##.####..#G
