S...#.#.##......#...
......#.##..........
#..##...#...#.#.#...
...###..#...#.#.#...
#..#.###.#.#.....#.#
#......##.....#.#...
...#.#......###...#.
..........##..##...#
.#.............###..
..##...#.#.....##.#.
.....#..............
.....##..###.#...#..
#.#...#...#.#.......
....#.....##...#..#.
#.#..#..##.#..#....#
#..#..###....##.#...
#..#.##..#..#.#.....
...##.......#..#....
.#..####....#.#....#
............#....#.G
