S.#..#....
.##..###.#
..##.##...
..##......
#...##..##
....#.....
#.#.#..#..
.....##...
.#...#.##.
.##.#....G
