S..........#...
#......#.....#.
...###.........
.#..#......##..
...##.......#..
..#.....#......
..#........##..
.......#.#..#..
.......#......#
..........#....
...#..........#
#.......##...#.
.#....#..#.#..#
...............
.........#....G
